                                                                                                                                                                              **************************
                                                                                                                                                                            ****************************
                                                                                                                          * * ***                               ****       *****************************
                                                                                                                       ***********                               ****    *******************************
                                                                                                                   **********************  ******                 **       *****************************
                                                                                                              *****^^^*************************************       ***** ********************************
                                                                                                           ******^^^*****************************************        ***********************************
                                                                                                          *****^^^^******************************************     **************************************
                 * **                                                                                *     ***^^^^^^*****************************************    ***************************************
                *****                                                                                *     ***^^^^*****************************************    *****************************************
                 *****************                                                                     ****^^^^^******************************                ******************************************
                 **^^^**************                                                                   ****^^^^************************************              ***************************************
                 ***^^^*************                                                                 ***^^^^^**************************************      **     ****************************************
                **^^^^**************                                                              ***^^^^^^******************************************     **********************************************
                  ***^^^^********                                                                  ***^^^^^**************    *************************        ******************************************
                     ***                                                                         ****^^^^^************         *************************************************************************
                                                                                                ***^^^^^^************         **************************************************************************
                                                                                               ***^^^^^^^*************       ***************************************************************************
                                                                                             ***^^^^^^^***************      ******************************  ********************************************
                                                                                            ****^^^^^^**************      ********************************  ********************************************
                                                                                        *  ***^^^^^***************      **********************************      ****************************************
                                                                                        ****^^^^^^^*************        ************************************** *****************************************
                                                                                      ***^^^^^^^^**************         ************************       *************************************************
                                                                                ******^^^^^^^^^^***************          ************************       ************************************************
                                                                              *****^^^^^^^^^^^^^**************            ************************   ***************************************************
                                                                              ***^^^^^^^^^^^^******************           **************          ******************************************************
                                                            **               * ***^^^^^^^^^^*******************             *******           **********************************************************
                                                            *                  ****^^^^^^^^^^**********************                    *****************************************************************
                                                                              ***^^^^^^^^^^************************               **********************************************************************
                                                      **                       * ***^^^^^^** *********************            **************************************************************************
                                           **    *****                           **^^^^^****   *****************              **************************************************************************
                                         *    *******                          *********       ***************                      ********************************************************************
                                            * **********                          ***            **************     *         **************************************************************************
                                             ***********                                   **    **************    **        ***************************************************************************
                                             ****^****                                    ***     **************            ****************************************************************************
                                          ***  *^***                                  * ****       ***********              ****************************************************************************
                                    *******  ****^*****                               ********      *********                ***************************************************************************
                                   *******   ****^******                              *****     * * ****                      **************************************************************************
                              *************      *******                               *** **  ****                        *****************************************************************************
                            ************         ********                             *****    ** *               **************************************************************************************
                             ***********          *********                             ***           *        *****************************************************************************************
                           ************           *********                             ******  ******** ***********************************************************************************************
                         *************       ****^**********                      **********************************************************************************************************************
                          ****               *^^^**************             ****************************************************************************************************************************
                                         *****^*****************          ******************************************************************************************************************************
                                              ****************           *******************************************************************************************************************************
                                          ******************          **********************************************************************************************************************************
                                       ******    *     ****      ***************************************************************************************************************************************
                                                               **********************************************************************************************************************************    ***
                                                              ********************************************************************************************************************************    ******
                                                   **     *********************************************************************************************************************************          ***
                                       ******      *************************************************************************************************************************************           *****
                                       ***********************************************************************************************************************************************             *****
                                            ******************************************************************************************^^^^^*****************************      *     *****   *** ********
                                              *****************************************************************************************^^^^^^^^^***********************          **********             
                                               ******************************************************************************************^^^^^^^^^********************               ***                
                                                *******************************************************************************************^^^^^^^^*******************               **                 
                                                  **************************************^^^^^^^^^^^^^^^^^^^^^******************************^^^^^^^*******************                                   
                                                  **********************************^^^^^^^^^^^^^^^^*******^^^^^^*************************^^^^^^^^******************                                    
                                                 **********************************^^^^^^^^^^^^^^^*****   ***^^^^^*************************^^^^^^^^^****************                                    
                                                 ******************************^^^^^^^^^************      ****^^^*************************^^^^^^^^^*****************                           **       
                **********                      ****************************^^^^^^^^^***************        * **^^^^********************^^^^^^^^^******************                      ***************
                **********************         ***************************************  *************           ***^^^^^^***********^^^^^**************************                  *******************
                 *****^^^^^^^^^^^**************^^^^^^*******************************         ******^***          * *****^^^^^^*****^^^^^***************************                *********************
                ****^^^^^^*****^^^^^^^^****^^^^^^^^^^^^^^^^******       *******              ********^****           *  ****^^^^^^^^^^^^^^***************************             **********************
                ***^^^^^^********************^^^^^^^^^^^^^^^^***                         *    *********^***                 *******^^^^^^^^^****************************  ******************************
               **********^^^^^************************^^^^^^^^**                       ***      *********^***                     ****^^^*************************         *****************************
              **************************************************                       **          ********^**** * *               **^^^^^^**************           ************************************
            ***********************************************                            **             ********^^****               ***^^^^***********           ****************************************
           ******************************************                                   *                   ***************        ****^^^^***********     *    **********************************^^^^^^
         ******************************************                                 ******                      ********* *****     *****^^^^******             *  ******************************^^^^^^*
           **************************************           **    *                  *****                        ******      *        *^^^^^*******     *          ************************^^^^^^^^****
          **************************************           *****                      ****                           ****                ***^^^*******           ******************^^^^^^^^^^^^^^^^*****  
          *************************^^^^^^^^^*****      *      *                      *****                            ****               **^^^^***********           * *********^^^^^*******************    
           ******************^^^^^^^^^^********                                       *                              ***                 ****************                *****^^^^^^*****            ***   
                   ****^^^^^^^^^^^^^^********                                                                        **                      **********         *      * **************              *** 
                   ******^^^^^^^^^^******                                                               ************                            ******       *              **                    ****** 
                    ****           ***                                                                   *********                              *                                                       
                                    **                                                                    ****                                         *****                                            
                                        ****                                                                                                              ********                                      
                                          ********                        ************************                                          *                   *        * *** **        ***************        
                                              ***              **********************************                                                                                   ********************        
                                              ****     *     ****************^^^**********************                                         *****                         ***       ****^^^^*********       
                                             ***************************^^^^^^^^********************                                                                                   ***^^^***********       
                                           *************^^^^^^^^*****^^^^^^^^^^^^^^^****************      *   * **                                                                    ******^^^^********       
                                      *******^^^^^^^^^^**********^^^^^^^^^^^^^^^***********************                                                                              ****^^^^^**********       
                                    *****^^^^^^^^^^^^****************^^^^^^^^^^^*********************************                     ********                                       *******************       
                                   *****^^^^^^^^^^^^^^**************************************************************              *****************                                 ********************       
                                  ***^^^^^^^^^^^^^^**********************************************************************          **************************      ********  * ** **********************       
                                  ******^^^^^^^^^*****************************************************************************   ***********************************************************************       
                                 *******^^^^^^^^********************************************************************************************************************************************************       
    **   **                 *********^^^^^^^^^**********************************************************************************************************************************************************    
           *                *****^^^^^^^^***************************************************************************************************************************************** *********************       
                       ********************************************************************************************************************************************************      *******************       
                      **********************************************************************************************************************************************************       *****************       
                   **************************************************************************************************************************************************************        ***************       
                  ****************************************************************************************************************************************************************        **************       
                 *******************************************************************************************************************************************************************       *************       
               **********************************************************************************************************************************************************************        ***********       
              ***********************************************************************************************************************************************************************          *********