                                                                                                                                                                              **************************
                                                                                                                                                                            ****************************
                                                                                                                          * * ***                               ****       *****************************
                                                                                                                       ***********                               ****    *******************************
                                                                                                                   **********************  ******                 **       *****************************
                                                                                                              *********************************************       ***** ********************************
                                                                                                           **************************************************        ***********************************
                                                                                                          ****************************************************     *************************************
                 * **                                                                                *     **************************************************    ***************************************
                *****                                                                                *     ************************************************    *****************************************
                 *****************                                                                     ***************************************                ******************************************
                 *******************                                                                   ********************************************              ***************************************
                 *******************                                                                 **********************************************      **     ****************************************
                ********************                                                              ***************************************************     **********************************************
                  ***************                                                                  **********************    *************************        ******************************************
                     ***                                                                         *********************         *************************************************************************
                                                                                                *********************         **************************************************************************
                                                                                               ***********************       ***************************************************************************
                                                                                             *************************      ******************************  ********************************************
                                                                                            ************************      ********************************  ********************************************
                                                                                        *  ***********************      **********************************      ****************************************
                                                                                        ************************        ************************************** *****************************************
                                                                                      *************************         ************************       *************************************************
                                                                                *******************************          ************************       ************************************************
                                                                              ********************************            ************************   ***************************************************
                                                                              ********************************           **************          *******************************************************
                                                            **               * ********************************             *******           **********************************************************
                                                            *                  ***********************************                    ******************************************************************
                                                                              *************************************               **********************************************************************
                                                      **                       * *********** *********************            **************************************************************************
                                           **    *****                           ***********   *****************              **************************************************************************
                                         *    *******                          *********       ***************                      ********************************************************************
                                            * **********                          ***            **************     *         **************************************************************************
                                             ***********                                   **    **************    **        ***************************************************************************
                                             *********                                    ***     **************            ****************************************************************************
                                          ***  *****                                  * ****       ***********              ****************************************************************************
                                    *******  **********                               ********      *********                ***************************************************************************
                                   *******   ***********                              *****     * * ****                      **************************************************************************
                              *************      *******                               *** **  ****                        *****************************************************************************
                            ************         ********                             *****    ** *               **************************************************************************************
                             ***********          *********                             ***           *        *****************************************************************************************
                           ************           *********                             ******  ******** ***********************************************************************************************
                         *************       ***************                      **********************************************************************************************************************
                          ****               ******************             ****************************************************************************************************************************
                                         ***********************          ******************************************************************************************************************************
                                              ****************           *******************************************************************************************************************************
                                          ******************          **********************************************************************************************************************************
                                       ******    *     ****      ***************************************************************************************************************************************
                                                               **********************************************************************************************************************************    ***
                                                              ********************************************************************************************************************************    ******
                                                   **     *********************************************************************************************************************************          ***
                                       ******      *************************************************************************************************************************************           *****
                                       ***********************************************************************************************************************************************             *****
                                            ****************************************************************************************************************************      *     *****   *** ********
                                              *************************************************************************************************************************          **********             
                                               ***********************************************************************************************************************               ***                
                                                **********************************************************************************************************************               **                 
                                                  *******************************************************************************************************************                                   
                                                  ******************************************************************************************************************                                    
                                                 ******************************************************   **********************************************************                                    
                                                 ***************************************************      **********************************************************                           **       
                **********                      ****************************************************        * *****************************************************                      ***************
                **********************         ***************************************  *************           ***************************************************                  *******************
                 *******************************************************************         **********          * ************************************************                *********************
                *************************************************       *******              *************           *  *********************************************             **********************
                ************************************************                         *    *************                 ********************************************  ******************************
               *************************************************                       ***      *************                     ********************************         *****************************
              **************************************************                       **          ************* * *               **********************           ************************************
            ***********************************************                            **             **************               ******************           ****************************************
           ******************************************                                   *                   **************         *******************     *    ****************************************
         ******************************************                                 ******                      ********* *****     ***************             *  *************************************
           **************************************           **    *                  *****                        ******      *        *************     *          ************************************
          **************************************           *****                      ****                           ****                *************           ***************************************  
          ***************************************      *      *                      *****                            ****               *****************           * *********************************    
           ************************************                                       *                              ***                 ****************                ****************            ***   
                   **************************                                                                        **                      **********         *      * **************              *** 
                   *********************                                                               ************                            ******       *              **                    ******* 
                    ****           * *                                                                   *********                              *                                                       
                                                                                                               ****                                         *****                                       
                                                                                                                                                          ********                                 
                                              *****                       ***************************                                       *                   *        * *** **        ***************        
                                                *              **********************************                                                                                   ********************        
                                              ****     *     *****************************************                                         *****                         ***       *****************       
                                             *******************************************************                                                                                   *****************       
                                           ********************************************************      *   * **                                                                    *******************       
                                      *****************************************************************                                                                              *******************       
                                    ****************************************************************************                     ********                                       ********************       
                                   *********************************************************************************              *****************                                 ********************       
                                  ***************************************************************************************          **************************      ********  * ** **********************       
                                  ********************************************************************************************   ***********************************************************************       
                                 ***********************************************************************************************************************************************************************       
    **   **                 ****************************************************************************************************************************************************************************    
           *                ****************************************************************************************************************************************************** *********************       
                       ********************************************************************************************************************************************************      *******************       
                      **********************************************************************************************************************************************************       *****************       
                   **************************************************************************************************************************************************************        ***************       
                  ****************************************************************************************************************************************************************        **************       
                 *******************************************************************************************************************************************************************       *************       
               **********************************************************************************************************************************************************************        ***********       
              ***********************************************************************************************************************************************************************          *********
