                                         \
                ******
              ************
            ****************                
            ****************                                
              ************
              ****************
            ***************
                ********
                
                



                            **
                      ************
                    *************     
                    ***************
                     ********


                                            /